Leo->Mark
Mark->Gabriel
Gabriel->Marina
Marina->Paula
Paula->Bruno
Bruno->Bethany
Bethany->Samir
Samir->Priscilla
Priscilla->Lucas
Lucas->Philip
Philip->Jane
Jane->Danielle
Danielle->Sean
Sean->Joe
Joe->Anderson
Anderson->Winnie
Winnie->Andre
Andre->Brian
Brian->Regis
Regis->Cinthia
Cinthia->Julianna
Julianna->Andrea
Andrea->Amy
Amy->Alex
Alex->Matthew
Matthew->Mary
Mary->Martha
Martha->Arthur
Arthur->Anna
Anna->Leo
